Species,Genotype,Total,quarter,half,threeQuarter,full,Unknown,TotalNEw,Check
APAL,AP?,6,0,0,0,0,6,6,Match
APAL,AP10,8,0,0,1,5,2,8,Match
APAL,AP102,68,33,0,0,29,6,68,Match
APAL,AP106,1,0,0,0,1,0,1,Match
APAL,AP108,5,0,0,0,4,1,5,Match
APAL,AP110,188,0,0,57,131,0,188,Match
APAL,AP113,19,0,0,0,0,19,19,Match
APAL,AP115,1,0,0,0,1,0,1,Match
APAL,AP119,16,0,0,0,0,16,16,Match
APAL,AP120,103,0,56,42,4,1,103,Match
APAL,AP121,12,0,0,0,12,0,12,Match
APAL,AP124,27,0,0,0,7,20,27,Match
APAL,AP126,69,0,0,0,3,66,69,Match
APAL,AP13,85,69,0,0,16,0,85,Match
APAL,AP131,9,0,0,8,0,1,9,Match
APAL,AP134,36,0,0,0,0,36,36,Match
APAL,AP135,1,0,0,0,1,0,1,Match
APAL,AP14,203,0,0,0,203,0,203,Match
APAL,AP144,43,0,0,0,5,38,43,Match
APAL,AP145,22,22,0,0,0,0,22,Match
APAL,AP146,120,3,65,52,0,0,120,Match
APAL,AP147,84,0,76,4,0,4,84,Match
APAL,AP15,56,0,0,0,56,0,56,Match
APAL,AP16,63,0,0,53,0,10,63,Match
APAL,AP17,113,31,0,0,8,74,113,Match
APAL,AP18,18,0,0,0,18,0,18,Match
APAL,AP19,33,0,0,0,33,0,33,Match
APAL,AP20,95,0,0,0,2,93,95,Match
APAL,AP23,408,112,213,7,1,75,408,Match
APAL,AP24,60,0,4,24,32,0,60,Match
APAL,AP26,58,0,0,0,58,0,58,Match
APAL,AP274,4,0,0,0,0,4,4,Match
APAL,AP3,7,0,7,0,0,0,7,Match
APAL,AP35,125,117,0,2,0,6,125,Match
APAL,AP36,41,41,0,0,0,0,41,Match
APAL,AP364,41,0,41,0,0,0,41,Match
APAL,AP365,25,25,0,0,0,0,25,Match
APAL,AP366,16,16,0,0,0,0,16,Match
APAL,AP37,149,71,0,0,56,22,149,Match
APAL,AP370,18,0,0,0,0,18,18,Match
APAL,AP374,41,41,0,0,0,0,41,Match
APAL,AP378,19,0,0,0,19,0,19,Match
APAL,AP38,42,42,0,0,0,0,42,Match
APAL,AP380,6,0,0,0,0,6,6,Match
APAL,AP382,24,0,0,24,0,0,24,Match
APAL,AP383,29,0,0,0,0,29,29,Match
APAL,AP385,19,0,0,19,0,0,19,Match
APAL,AP387,22,0,0,0,0,22,22,Match
APAL,AP39,69,6,0,31,0,32,69,Match
APAL,AP390,4,4,0,0,0,0,4,Match
APAL,AP391,7,0,0,0,0,7,7,Match
APAL,AP392,28,0,0,0,0,28,28,Match
APAL,AP393,24,0,0,0,0,24,24,Match
APAL,AP394,7,0,0,0,0,7,7,Match
APAL,AP396,1,0,0,1,0,0,1,Match
APAL,AP397,104,0,65,0,0,39,104,Match
APAL,AP398,2,0,2,0,0,0,2,Match
APAL,AP4,23,0,0,0,23,0,23,Match
APAL,AP40,92,0,53,23,0,16,92,Match
APAL,AP400,27,0,0,0,27,0,27,Match
APAL,AP401,4,0,4,0,0,0,4,Match
APAL,AP402,17,0,0,17,0,0,17,Match
APAL,AP403,3,2,0,0,1,0,3,Match
APAL,AP405,2,0,0,0,0,2,2,Match
APAL,AP406,24,0,0,24,0,0,24,Match
APAL,AP407,1,1,0,0,0,0,1,Match
APAL,AP408,110,110,0,0,0,0,110,Match
APAL,AP41,49,0,45,4,0,0,49,Match
APAL,AP410,1,1,0,0,0,0,1,Match
APAL,AP411,7,7,0,0,0,0,7,Match
APAL,AP42,63,0,59,0,0,4,63,Match
APAL,AP426,26,16,10,0,0,0,26,Match
APAL,AP427,15,0,0,4,0,11,15,Match
APAL,AP428,6,0,6,0,0,0,6,Match
APAL,AP44,18,0,8,0,4,6,18,Match
APAL,AP45,59,19,24,0,0,16,59,Match
APAL,AP46,54,0,0,54,0,0,54,Match
APAL,AP47,11,0,11,0,0,0,11,Match
APAL,AP48,49,0,45,0,0,4,49,Match
APAL,AP49,26,26,0,0,0,0,26,Match
APAL,AP5,2,0,0,0,2,0,2,Match
APAL,AP52,34,34,0,0,0,0,34,Match
APAL,AP53,63,0,0,24,4,35,63,Match
APAL,AP58,1,0,0,0,1,0,1,Match
APAL,AP6,78,77,0,0,1,0,78,Match
APAL,AP60,4,0,4,0,0,0,4,Match
APAL,AP63,70,70,0,0,0,0,70,Match
APAL,AP68,96,52,0,0,44,0,96,Match
APAL,AP7,215,97,24,0,74,20,215,Match
APAL,AP70,6,0,0,0,6,0,6,Match
APAL,AP71,1,1,0,0,0,0,1,Match
APAL,AP76,54,53,0,0,0,1,54,Match
APAL,AP8,66,0,0,2,37,27,66,Match
APAL,AP82,32,0,0,28,4,0,32,Match
APAL,AP83,66,53,13,0,0,0,66,Match
APAL,AP84,9,0,0,0,9,0,9,Match
APAL,AP9,29,29,0,0,0,0,29,Match
APAL,AP96,27,0,26,0,0,1,27,Match
APAL,AP98,49,0,0,0,1,48,49,Match
APAL,AP99,2,0,0,2,0,0,2,Match
CNAT,CN19,30,0,0,0,30,0,30,Match
CNAT,CN21,81,0,0,0,30,51,81,Match
CNAT,CN37,1,0,0,0,0,1,1,Match
CNAT,CN46,1,0,0,0,0,1,1,Match
CNAT,CN51,1,0,0,0,1,0,1,Match
CNAT,CN53,1,0,0,0,1,0,1,Match
CNAT,CN62,1,0,0,0,1,0,1,Match
CNAT,CN63,1,0,0,0,1,0,1,Match
CNAT,CN64,1,0,0,0,1,0,1,Match
CNAT,CN65,1,0,0,0,1,0,1,Match
CNAT,CN66,1,0,0,0,1,0,1,Match
CNAT,CN70,1,0,0,0,1,0,1,Match
CNAT,CN71,1,0,0,0,1,0,1,Match
CNAT,CN72,1,0,0,0,1,0,1,Match
CNAT,CN75,1,0,0,0,1,0,1,Match
CNAT,CN77,1,0,0,0,1,0,1,Match
CNAT,CN85,1,0,0,0,1,0,1,Match
CNAT,CN86,1,0,0,0,1,0,1,Match
CNAT,CN87,3,0,0,0,3,0,3,Match
CNAT,CN88,1,0,0,0,1,0,1,Match
DLAB,DL1,21,0,0,8,13,0,21,Match
DLAB,DL10,2,0,0,0,2,0,2,Match
DLAB,DL103,19,0,0,0,19,0,19,Match
DLAB,DL11,8,0,0,8,0,0,8,Match
DLAB,DL12,8,0,0,0,8,0,8,Match
DLAB,DL140,7,0,0,0,7,0,7,Match
DLAB,DL165,49,0,39,0,10,0,49,Match
DLAB,DL166,14,0,0,0,14,0,14,Match
DLAB,DL171,2,0,0,0,2,0,2,Match
DLAB,DL172,5,0,0,0,5,0,5,Match
DLAB,DL173,8,0,0,0,8,0,8,Match
DLAB,DL174,7,0,0,0,7,0,7,Match
DLAB,DL175,10,0,0,0,10,0,10,Match
DLAB,DL178,12,0,0,0,12,0,12,Match
DLAB,DL179,8,0,0,0,8,0,8,Match
DLAB,DL181,7,0,0,0,7,0,7,Match
DLAB,DL182,5,0,0,0,5,0,5,Match
DLAB,DL184,5,0,0,0,5,0,5,Match
DLAB,DL185,16,0,0,0,16,0,16,Match
DLAB,DL186,6,0,0,0,6,0,6,Match
DLAB,DL187,3,0,0,0,3,0,3,Match
DLAB,DL188,9,0,0,0,9,0,9,Match
DLAB,DL189,4,0,0,0,4,0,4,Match
DLAB,DL192,10,0,0,0,10,0,10,Match
DLAB,DL193,6,0,0,0,6,0,6,Match
DLAB,DL194,2,0,0,0,2,0,2,Match
DLAB,DL195,11,0,0,0,11,0,11,Match
DLAB,DL196,8,0,0,0,8,0,8,Match
DLAB,DL197,8,0,0,0,8,0,8,Match
DLAB,DL198,3,0,0,0,3,0,3,Match
DLAB,DL199,8,0,0,0,8,0,8,Match
DLAB,DL2,9,0,0,9,0,0,9,Match
DLAB,DL200,4,0,0,0,4,0,4,Match
DLAB,DL201,30,0,15,0,15,0,30,Match
DLAB,DL203,58,0,30,15,13,0,58,Match
DLAB,DL204,6,0,0,0,6,0,6,Match
DLAB,DL205,2,0,0,0,2,0,2,Match
DLAB,DL206,7,0,0,0,7,0,7,Match
DLAB,DL207,6,0,0,0,6,0,6,Match
DLAB,DL208,4,0,0,0,4,0,4,Match
DLAB,DL210,13,0,0,0,13,0,13,Match
DLAB,DL211,8,0,0,0,8,0,8,Match
DLAB,DL215,30,30,0,0,0,0,30,Match
DLAB,DL216,10,0,0,0,10,0,10,Match
DLAB,DL217,3,0,0,0,3,0,3,Match
DLAB,DL219,3,0,0,0,3,0,3,Match
DLAB,DL221,4,0,0,0,4,0,4,Match
DLAB,DL222,4,0,0,0,4,0,4,Match
DLAB,DL223,3,0,0,0,3,0,3,Match
DLAB,DL225,5,0,0,0,5,0,5,Match
DLAB,DL226,4,0,0,0,4,0,4,Match
DLAB,DL228,4,0,0,0,4,0,4,Match
DLAB,DL229,2,0,0,0,2,0,2,Match
DLAB,DL230,3,0,0,0,3,0,3,Match
DLAB,DL231,6,0,0,0,6,0,6,Match
DLAB,DL232,4,0,0,4,0,0,4,Match
DLAB,DL233,12,0,0,0,12,0,12,Match
DLAB,DL234,8,0,0,0,8,0,8,Match
DLAB,DL237,6,0,0,0,6,0,6,Match
DLAB,DL238,5,0,0,0,5,0,5,Match
DLAB,DL239,4,0,0,0,4,0,4,Match
DLAB,DL240,6,0,0,0,6,0,6,Match
DLAB,DL241,2,0,0,0,2,0,2,Match
DLAB,DL244,6,0,0,0,6,0,6,Match
DLAB,DL245,3,0,0,0,3,0,3,Match
DLAB,DL246,8,0,0,0,8,0,8,Match
DLAB,DL247,4,0,0,0,4,0,4,Match
DLAB,DL248,5,0,0,0,5,0,5,Match
DLAB,DL249,6,0,0,0,6,0,6,Match
DLAB,DL250,4,0,0,0,4,0,4,Match
DLAB,DL251,4,0,0,0,4,0,4,Match
DLAB,DL252,4,0,0,0,4,0,4,Match
DLAB,DL253,4,0,0,4,0,0,4,Match
DLAB,DL255,1,0,0,0,0,1,1,Match
DLAB,DL257,26,0,16,0,10,0,26,Match
DLAB,DL258,3,0,0,0,3,0,3,Match
DLAB,DL259,3,0,0,0,3,0,3,Match
DLAB,DL260,3,0,0,0,3,0,3,Match
DLAB,DL261,3,0,0,0,3,0,3,Match
DLAB,DL262,3,0,0,3,0,0,3,Match
DLAB,DL263,4,0,0,0,4,0,4,Match
DLAB,DL264,4,0,0,0,4,0,4,Match
DLAB,DL265,4,0,0,0,4,0,4,Match
DLAB,DL266,4,0,0,0,4,0,4,Match
DLAB,DL269,8,0,0,0,8,0,8,Match
DLAB,DL270,4,0,0,0,4,0,4,Match
DLAB,DL271,6,0,0,0,6,0,6,Match
DLAB,DL273,1,0,0,0,1,0,1,Match
DLAB,DL274,1,0,0,0,1,0,1,Match
DLAB,DL275,20,20,0,0,0,0,20,Match
DLAB,DL279,1,0,0,0,1,0,1,Match
DLAB,DL280,1,0,0,0,1,0,1,Match
DLAB,DL281,1,0,0,0,1,0,1,Match
DLAB,DL285,1,0,0,0,1,0,1,Match
DLAB,DL286,1,0,0,0,1,0,1,Match
DLAB,DL287,3,0,0,0,3,0,3,Match
DLAB,DL288,1,0,0,0,1,0,1,Match
DLAB,DL289,1,0,0,0,1,0,1,Match
DLAB,DL290,11,0,0,0,11,0,11,Match
DLAB,DL3,155,62,9,0,56,28,155,Match
DLAB,DL4,10,0,0,0,10,0,10,Match
DLAB,DL5,9,0,0,0,9,0,9,Match
DLAB,DL60,1,0,0,0,1,0,1,Match
DLAB,DL7,16,0,0,0,16,0,16,Match
DLAB,DL8,26,0,0,26,0,0,26,Match
DLAB,DL81,1,0,0,0,1,0,1,Match
DLAB,DL84,1,0,0,0,1,0,1,Match
DLAB,DL9,12,0,0,0,12,0,12,Match
DSTO,DS10,1,0,0,0,0,1,1,Match
DSTO,DS11,29,29,0,0,0,0,29,Match
DSTO,DS12,1,0,0,0,0,1,1,Match
DSTO,DS13,1,0,0,0,0,1,1,Match
DSTO,DS6,1,0,0,0,0,1,1,Match
DSTO,DS8,1,0,0,0,0,1,1,Match
DSTO,DS9,1,0,0,0,0,1,1,Match
FFRA,FF1,3,0,0,0,3,0,3,Match
UK,I,7,0,0,0,7,0,7,Match
UK,I1A,5,0,0,0,5,0,5,Match
UK,I2A,18,0,0,0,18,0,18,Match
UK,I3A,2,0,0,0,2,0,2,Match
MCAV,MC1,36,0,0,0,6,30,36,Match
MCAV,MC1003,6,0,0,6,0,0,6,Match
MCAV,MC102,28,0,19,9,0,0,28,Match
MCAV,MC103,12,0,0,0,0,12,12,Match
MCAV,MC106,53,0,13,10,30,0,53,Match
MCAV,MC107,197,0,98,69,30,0,197,Match
MCAV,MC108,154,154,0,0,0,0,154,Match
MCAV,MC111,108,0,108,0,0,0,108,Match
MCAV,MC112,170,0,110,60,0,0,170,Match
MCAV,MC127,62,0,0,0,62,0,62,Match
MCAV,MC202,4,0,0,0,4,0,4,Match
MCAV,MC203,11,0,0,0,11,0,11,Match
MCAV,MC204,3,0,0,0,3,0,3,Match
MCAV,MC205,13,0,0,0,13,0,13,Match
MCAV,MC211,1,0,0,0,0,1,1,Match
MCAV,MC212,2,0,0,0,0,2,2,Match
MCAV,MC43,1,0,1,0,0,0,1,Match
MCAV,MC45,1,0,1,0,0,0,1,Match
MCAV,MC52,9,0,9,0,0,0,9,Match
MCAV,MC57,75,0,71,0,4,0,75,Match
MCAV,MC59,107,66,9,18,5,9,107,Match
MCAV,MC60,82,0,0,52,30,0,82,Match
MCAV,MC61,8,0,8,0,0,0,8,Match
MCAV,MC62,132,110,0,22,0,0,132,Match
MCAV,MC63,15,0,0,15,0,0,15,Match
MCAV,MC64,3,0,3,0,0,0,3,Match
MCAV,MC71,16,0,0,16,0,0,16,Match
MCAV,MC72,27,0,0,17,10,0,27,Match
OFAV,OF,3,0,0,0,3,0,3,Match
OFAV,OF1,21,0,0,11,10,0,21,Match
OFAV,OF100,176,0,136,40,0,0,176,Match
OFAV,OF1000,9,0,0,9,0,0,9,Match
OFAV,OF1002,290,180,45,65,0,0,290,Match
OFAV,OF1003,23,0,21,0,0,2,23,Match
OFAV,OF1004,689,439,28,127,0,95,689,Match
OFAV,OF1005,285,0,10,245,0,30,285,Match
OFAV,OF1006,399,0,204,54,0,141,399,Match
OFAV,OF1017,5,0,0,5,0,0,5,Match
OFAV,OF1018,13,0,0,13,0,0,13,Match
OFAV,OF1019,11,0,0,11,0,0,11,Match
OFAV,OF1020,2,0,0,0,2,0,2,Match
OFAV,OF1022,4,0,0,0,4,0,4,Match
OFAV,OF1026,3,0,0,0,3,0,3,Match
OFAV,OF1032,3,0,0,0,3,0,3,Match
OFAV,OF1034,25,0,0,0,25,0,25,Match
OFAV,OF1035,3,0,0,0,3,0,3,Match
OFAV,OF1036,1,0,0,0,1,0,1,Match
OFAV,OF1038,4,0,0,0,4,0,4,Match
OFAV,OF1039,6,0,0,0,6,0,6,Match
OFAV,OF1040,8,0,0,0,8,0,8,Match
OFAV,OF1041,249,249,0,0,0,0,249,Match
OFAV,OF1042,1,0,0,0,1,0,1,Match
OFAV,OF1043,1,0,0,0,1,0,1,Match
OFAV,OF125,2,0,0,0,0,2,2,Match
OFAV,OF132,4,0,4,0,0,0,4,Match
OFAV,OF15,6,0,0,6,0,0,6,Match
OFAV,OF3,89,0,0,53,3,33,89,Match
OFAV,OF3112,1,0,0,0,1,0,1,Match
OFAV,OF320,1,0,0,0,1,0,1,Match
OFAV,OF328,134,45,87,0,2,0,134,Match
OFAV,OF338,1,0,0,0,1,0,1,Match
OFAV,OF388,1,0,0,0,1,0,1,Match
OFAV,OF389,1,0,0,0,1,0,1,Match
OFAV,OF393,2,2,0,0,0,0,2,Match
OFAV,OF441,17,0,0,0,4,13,17,Match
OFAV,OF457,20,0,0,0,20,0,20,Match
OFAV,OF61,75,0,35,40,0,0,75,Match
OFAV,OF61.113,1,0,0,0,1,0,1,Match
OFAV,OF61.71,1,0,0,0,1,0,1,Match
OFAV,OF61.77,1,0,0,0,1,0,1,Match
OFAV,OF61.93,1,0,0,0,1,0,1,Match
OFAV,OF61.99,1,0,0,0,1,0,1,Match
OFAV,OF668,7,0,0,0,7,0,7,Match
OFAV,OF670,2,0,0,0,0,2,2,Match
OFAV,OF671,71,0,41,30,0,0,71,Match
OFAV,OF675,16,0,0,0,16,0,16,Match
OFAV,OF677,16,0,0,0,16,0,16,Match
OFAV,OF678,2,0,0,0,2,0,2,Match
OFAV,OF679,18,0,0,18,0,0,18,Match
OFAV,OF683,2,0,0,2,0,0,2,Match
OFAV,OF685,13,0,0,0,0,13,13,Match
OFAV,OF686,24,0,0,0,24,0,24,Match
OFAV,OF688,43,0,20,0,0,23,43,Match
OFAV,OF689,4,0,0,4,0,0,4,Match
OFAV,OF693,15,0,0,15,0,0,15,Match
OFAV,OF694,8,0,8,0,0,0,8,Match
OFAV,OF695,16,0,16,0,0,0,16,Match
OFAV,OF696,13,0,0,13,0,0,13,Match
OFAV,OF697,57,0,52,0,5,0,57,Match
OFAV,OF700,7,0,0,7,0,0,7,Match
OFAV,OF701,14,0,0,0,14,0,14,Match
OFAV,OF75,42,0,0,23,19,0,42,Match
OFAV,OF771,5,0,0,0,5,0,5,Match
OFAV,Of773,4,0,0,0,4,0,4,Match
OFAV,OF773,147,70,0,0,18,59,147,Match
OFAV,OF774,14,0,0,0,14,0,14,Match
OFAV,OF775,31,0,0,0,31,0,31,Match
OFAV,OF800,23,0,0,23,0,0,23,Match
OFAV,OF801,9,0,0,0,9,0,9,Match
OFAV,OF862,5,5,0,0,0,0,5,Match
OFAV,OF863,3,3,0,0,0,0,3,Match
OFAV,OF864,4,4,0,0,0,0,4,Match
OFAV,OF865,5,5,0,0,0,0,5,Match
OFAV,OF866,4,4,0,0,0,0,4,Match
OFAV,OF867,5,5,0,0,0,0,5,Match
OFAV,OF868,4,0,0,0,0,4,4,Match
OFAV,OF869,3,0,0,0,0,3,3,Match
OFAV,OF902,6,6,0,0,0,0,6,Match
OFAV,OF903,4,4,0,0,0,0,4,Match
OFAV,OF904,5,5,0,0,0,0,5,Match
OFAV,OF905,4,4,0,0,0,0,4,Match
OFAV,OF906,4,4,0,0,0,0,4,Match
OFAV,OF907,4,4,0,0,0,0,4,Match
OFAV,OF908,6,6,0,0,0,0,6,Match
OFAV,OF909,4,4,0,0,0,0,4,Match
OFAV,OF96,133,96,36,1,0,0,133,Match
OFAV,OF97,49,0,0,0,40,9,49,Match
OFAV,OF976,652,205,112,0,0,335,652,Match
OFAV,OF977,279,0,61,0,0,218,279,Match
OFAV,OF978,76,20,6,50,0,0,76,Match
OFAV,OF979,219,31,116,0,0,72,219,Match
OFAV,OF98,20,0,8,7,0,5,20,Match
OFAV,OF980,578,232,278,68,0,0,578,Match
OFAV,OF981,258,186,72,0,0,0,258,Match
OFAV,OF982,109,0,109,0,0,0,109,Match
OFAV,OF984,61,0,61,0,0,0,61,Match
OFAV,OF985,62,0,62,0,0,0,62,Match
OFAV,OF986,224,167,0,0,0,57,224,Match
OFAV,OF987,283,283,0,0,0,0,283,Match
OFAV,OF988,158,0,13,17,0,128,158,Match
OFAV,OF989,81,0,0,0,0,81,81,Match
OFAV,OF99,21,0,21,0,0,0,21,Match
OFAV,OF990,164,52,69,0,0,43,164,Match
OFAV,OF991,130,68,62,0,0,0,130,Match
OFAV,OF992,14,0,14,0,0,0,14,Match
OFAV,OF993,164,0,0,16,0,148,164,Match
OFAV,OF994,60,0,0,0,0,60,60,Match
OFAV,OF995,380,306,4,0,1,69,380,Match
OFAV,OF996,69,0,9,60,0,0,69,Match
OFAV,OF999,1231,66,0,0,0,1165,1231,Match
OFFR,OK1,26,0,0,0,26,0,26,Match
OFFR,OK2,1,0,0,0,1,0,1,Match
OROB,OR,13,0,8,0,0,5,13,Match
OROB,OR?,2,0,0,0,0,2,2,Match
PAST,PA?,27,27,0,0,0,0,27,Match
PAST,PA100,11,0,0,0,11,0,11,Match
PAST,PA101,8,0,0,0,8,0,8,Match
PAST,PA102,6,0,0,0,0,6,6,Match
PAST,PA103,31,0,0,0,15,16,31,Match
PAST,PA104,58,16,0,0,20,22,58,Match
PAST,PA106,12,0,0,0,12,0,12,Match
PAST,PA107,69,59,0,0,0,10,69,Match
PAST,PA109,5,0,0,0,0,5,5,Match
PAST,PA110,24,0,0,0,12,12,24,Match
PAST,PA111,8,0,0,0,8,0,8,Match
PAST,PA112,17,0,0,0,17,0,17,Match
PAST,PA113,65,65,0,0,0,0,65,Match
PAST,PA114,9,0,0,0,9,0,9,Match
PAST,PA115,12,0,0,0,12,0,12,Match
PAST,PA129,548,467,0,0,81,0,548,Match
PAST,PA130,87,87,0,0,0,0,87,Match
PAST,PA14,3,0,0,0,3,0,3,Match
PAST,PA22,29,0,0,0,15,14,29,Match
PAST,PA24,10,0,0,0,10,0,10,Match
PAST,PA25,8,0,0,0,8,0,8,Match
PAST,PA26,101,101,0,0,0,0,101,Match
PAST,PA28,1,0,0,0,1,0,1,Match
PAST,PA29,22,18,0,4,0,0,22,Match
PAST,PA33,2,0,0,0,2,0,2,Match
PAST,PA34,5,0,0,0,0,5,5,Match
PAST,PA35,12,0,0,0,12,0,12,Match
PAST,PA42,36,0,0,2,14,20,36,Match
PAST,PA45,16,0,0,16,0,0,16,Match
PAST,PA47,97,81,0,0,16,0,97,Match
PAST,PA50,159,143,0,0,0,16,159,Match
PAST,PA51,6,0,0,0,6,0,6,Match
PAST,PA52,9,0,0,0,9,0,9,Match
PAST,PA54,32,0,0,0,16,16,32,Match
PAST,PA55,21,0,0,0,10,11,21,Match
PAST,PA56,50,0,0,0,26,24,50,Match
PAST,PA60,12,0,0,0,12,0,12,Match
PAST,PA62,19,0,0,9,0,10,19,Match
PAST,PA64,63,55,0,0,8,0,63,Match
PAST,PA69,11,0,0,0,11,0,11,Match
PAST,PA70,18,0,0,0,5,13,18,Match
PAST,PA71,20,0,0,0,20,0,20,Match
PAST,PA72,6,0,0,0,6,0,6,Match
PAST,PA73,13,0,0,0,0,13,13,Match
PAST,PA74,20,0,0,0,20,0,20,Match
PAST,PA84,9,0,0,0,0,9,9,Match
PAST,PA85,4,0,0,0,0,4,4,Match
PAST,PA86,30,0,0,0,23,7,30,Match
PAST,PA87,11,0,0,0,11,0,11,Match
PAST,PA89,1,0,0,0,1,0,1,Match
PAST,PA90,22,0,0,0,22,0,22,Match
PAST,PA91,9,0,0,0,9,0,9,Match
PAST,PA92,18,0,0,0,14,4,18,Match
PAST,PA93,34,11,0,0,7,16,34,Match
PAST,PA96,36,0,0,0,21,15,36,Match
PAST,PA98,1,1,0,0,0,0,1,Match
PAST,PA99,22,12,0,0,0,10,22,Match
PCLI,PC13,102,101,0,1,0,0,102,Match
PCLI,PC15,11,0,0,11,0,0,11,Match
PCLI,PC16,131,39,86,0,6,0,131,Match
PCLI,PC18,97,0,95,0,2,0,97,Match
PCLI,PC19,401,0,300,99,2,0,401,Match
PCLI,PC41,39,0,3,16,20,0,39,Match
PCLI,PC44,34,0,33,0,0,1,34,Match
PCLI,PC54,80,40,40,0,0,0,80,Match
PCLI,PC55,90,0,90,0,0,0,90,Match
PCLI,PC56,1,0,0,0,1,0,1,Match
PCLI,PC57,2,0,0,0,2,0,2,Match
PCLI,PC58,2,0,0,0,0,2,2,Match
PCLI,PC59,2,0,0,0,0,2,2,Match
PCLI,PC60,1,0,0,0,0,1,1,Match
PPOR,PP16,1,0,0,0,0,1,1,Match
PPOR,PP17,1,0,0,0,0,1,1,Match
PPOR,PP18,1,0,0,0,0,1,1,Match
PPOR,PP19,1,0,0,0,0,1,1,Match
PPOR,PP20,1,0,0,0,0,1,1,Match
PPOR,PP21,1,0,0,0,0,1,1,Match
PPOR,PP22,1,0,0,0,0,1,1,Match
PPOR,PP23,1,0,0,0,0,1,1,Match
PPOR,PP24,1,0,0,0,0,1,1,Match
PSTR,PS,2,0,0,2,0,0,2,Match
PSTR,PS1,17,0,0,17,0,0,17,Match
PSTR,PS10,21,0,0,13,2,6,21,Match
PSTR,PS12,11,0,0,11,0,0,11,Match
PSTR,PS13,27,0,0,0,27,0,27,Match
PSTR,PS14,11,0,0,0,3,8,11,Match
PSTR,PS15,19,0,0,7,12,0,19,Match
PSTR,PS16,1,0,0,0,1,0,1,Match
PSTR,PS17,143,45,70,0,28,0,143,Match
PSTR,PS2,14,0,0,0,14,0,14,Match
PSTR,PS20,32,0,0,7,25,0,32,Match
PSTR,PS3,35,0,0,25,10,0,35,Match
PSTR,PS30,6,4,2,0,0,0,6,Match
PSTR,PS31,13,0,0,0,13,0,13,Match
PSTR,PS32,28,0,0,0,28,0,28,Match
PSTR,PS33,50,50,0,0,0,0,50,Match
PSTR,PS4,25,0,0,17,8,0,25,Match
PSTR,PS42,20,0,0,0,20,0,20,Match
PSTR,PS43,9,0,0,0,9,0,9,Match
PSTR,PS44,2,0,0,0,2,0,2,Match
PSTR,PS45,1,0,0,0,1,0,1,Match
PSTR,PS46,1,0,0,0,1,0,1,Match
PSTR,PS49,36,0,0,0,0,36,36,Match
PSTR,PS5,23,0,0,23,0,0,23,Match
PSTR,PS50,6,0,0,0,0,6,6,Match
PSTR,PS51,6,0,0,0,0,6,6,Match
PSTR,PS6,195,115,0,60,20,0,195,Match
PSTR,PS7,6,0,0,0,0,6,6,Match
PSTR,PS8,59,0,9,10,30,10,59,Match
PSTR,PS9,124,122,0,0,2,0,124,Match
SBOU,SB13,20,0,0,0,20,0,20,Match
SBOU,SB3,1,0,0,0,0,1,1,Match
SINT,SI1,18,0,0,0,18,0,18,Match
SINT,SI11,478,468,0,0,10,0,478,Match
SINT,SI12,453,453,0,0,0,0,453,Match
SINT,SI13,337,314,0,0,23,0,337,Match
SINT,SI14,2,0,0,0,2,0,2,Match
SINT,SI15,1,0,0,0,1,0,1,Match
SINT,SI16,2,0,0,0,2,0,2,Match
SINT,SI17,1,0,0,0,1,0,1,Match
SINT,SI179,1,0,0,0,0,1,1,Match
SINT,SI18,1,0,0,0,1,0,1,Match
SINT,SI180,1,0,0,0,0,1,1,Match
SINT,SI181,1,0,0,0,0,1,1,Match
SINT,SI182,1,0,0,0,0,1,1,Match
SINT,SI183,1,0,0,0,0,1,1,Match
SINT,SI184,1,0,0,0,0,1,1,Match
SINT,SI185,1,0,0,0,0,1,1,Match
SINT,SI186,1,0,0,0,0,1,1,Match
SINT,SI187,1,0,0,0,0,1,1,Match
SINT,SI188,1,0,0,0,0,1,1,Match
SINT,SI189,1,0,0,0,0,1,1,Match
SINT,SI19,1,0,0,0,1,0,1,Match
SINT,SI190,1,0,0,0,0,1,1,Match
SINT,SI191,1,0,0,0,0,1,1,Match
SINT,SI192,1,0,0,0,0,1,1,Match
SINT,SI193,1,0,0,0,0,1,1,Match
SINT,SI194,1,0,0,0,0,1,1,Match
SINT,SI195,1,0,0,0,0,1,1,Match
SINT,SI196,1,0,0,0,0,1,1,Match
SINT,SI197,1,0,0,0,0,1,1,Match
SINT,SI198,1,0,0,0,0,1,1,Match
SINT,SI199,1,0,0,0,0,1,1,Match
SINT,SI20,1,0,0,0,1,0,1,Match
SINT,SI200,1,0,0,0,0,1,1,Match
SINT,SI201,1,0,0,0,0,1,1,Match
SINT,SI202,1,0,0,0,0,1,1,Match
SINT,SI203,1,0,0,0,0,1,1,Match
SINT,SI204,1,0,0,0,0,1,1,Match
SINT,SI205,1,0,0,0,0,1,1,Match
SINT,SI206,1,0,0,0,0,1,1,Match
SINT,SI207,1,0,0,0,0,1,1,Match
SINT,SI208,1,0,0,0,0,1,1,Match
SINT,SI209,1,0,0,0,0,1,1,Match
SINT,SI21,1,0,0,0,1,0,1,Match
SINT,SI210,1,0,0,0,0,1,1,Match
SINT,SI211,1,0,0,0,0,1,1,Match
SINT,SI212,1,0,0,0,0,1,1,Match
SINT,SI213,1,0,0,0,0,1,1,Match
SINT,SI214,1,0,0,0,0,1,1,Match
SINT,SI215,1,0,0,0,0,1,1,Match
SINT,SI216,1,0,0,0,0,1,1,Match
SINT,SI217,1,0,0,0,0,1,1,Match
SINT,SI218,1,0,0,0,0,1,1,Match
SINT,SI219,1,0,0,0,0,1,1,Match
SINT,SI22,1,0,0,0,1,0,1,Match
SINT,SI220,1,0,0,0,0,1,1,Match
SINT,SI221,1,0,0,0,0,1,1,Match
SINT,SI222,1,0,0,0,0,1,1,Match
SINT,SI223,1,0,0,0,0,1,1,Match
SINT,SI224,1,0,0,0,0,1,1,Match
SINT,SI225,1,0,0,0,0,1,1,Match
SINT,SI226,1,0,0,0,0,1,1,Match
SINT,SI227,1,0,0,0,0,1,1,Match
SINT,SI228,1,0,0,0,0,1,1,Match
SINT,SI229,1,0,0,0,0,1,1,Match
SINT,SI23,1,0,0,0,1,0,1,Match
SINT,SI230,1,0,0,0,0,1,1,Match
SINT,SI231,1,0,0,0,0,1,1,Match
SINT,SI232,1,0,0,0,0,1,1,Match
SINT,SI233,1,0,0,0,0,1,1,Match
SINT,SI234,1,0,0,0,0,1,1,Match
SINT,SI235,1,0,0,0,0,1,1,Match
SINT,SI236,1,0,0,0,0,1,1,Match
SINT,SI237,1,0,0,0,0,1,1,Match
SINT,SI238,1,0,0,0,0,1,1,Match
SINT,SI239,1,0,0,0,0,1,1,Match
SINT,SI24,1,0,0,0,1,0,1,Match
SINT,SI240,1,0,0,0,0,1,1,Match
SINT,SI241,1,0,0,0,0,1,1,Match
SINT,SI242,1,0,0,0,0,1,1,Match
SINT,SI243,1,0,0,0,0,1,1,Match
SINT,SI244,1,0,0,0,0,1,1,Match
SINT,SI245,1,0,0,0,0,1,1,Match
SINT,SI246,9,0,0,0,9,0,9,Match
SINT,SI25,1,0,0,0,1,0,1,Match
SINT,SI26,1,0,0,0,1,0,1,Match
SINT,SI27,1,0,0,0,1,0,1,Match
SINT,SI28,1,0,0,0,1,0,1,Match
SINT,SI29,1,0,0,0,1,0,1,Match
SINT,SI3,11,0,0,0,11,0,11,Match
SINT,SI30,1,0,0,0,1,0,1,Match
SINT,SI31,1,0,0,0,1,0,1,Match
SINT,SI32,1,0,0,0,1,0,1,Match
SINT,SI33,1,0,0,0,1,0,1,Match
SINT,SI34,1,0,0,0,1,0,1,Match
SINT,SI35,1,0,0,0,1,0,1,Match
SINT,SI36,1,0,0,0,1,0,1,Match
SINT,SI37,1,0,0,0,1,0,1,Match
SINT,SI38,1,0,0,0,1,0,1,Match
SINT,SI39,1,0,0,0,1,0,1,Match
SINT,SI4,6,0,6,0,0,0,6,Match
SINT,SI40,1,0,0,0,1,0,1,Match
SINT,SI41,1,0,0,0,1,0,1,Match
SINT,SI42,1,0,0,0,1,0,1,Match
SINT,SI43,1,0,0,0,0,1,1,Match
SINT,SI44,1,0,0,0,0,1,1,Match
SINT,SI45,1,0,0,0,0,1,1,Match
SINT,SI46,1,0,0,0,0,1,1,Match
SINT,SI47,1,0,0,0,0,1,1,Match
SINT,SI48,1,0,0,0,0,1,1,Match
SINT,SI49,1,0,0,0,0,1,1,Match
SINT,SI50,1,0,0,0,0,1,1,Match
SINT,SI51,1,0,0,0,0,1,1,Match
SINT,SI52,1,0,0,0,0,1,1,Match
SINT,SI54,1,0,0,0,0,1,1,Match
SINT,SI55,1,0,0,0,0,1,1,Match
SINT,SI56,1,0,0,0,0,1,1,Match
SINT,SI57,1,0,0,0,0,1,1,Match
SINT,SI58,1,0,0,0,0,1,1,Match
SINT,SI59,1,0,0,0,0,1,1,Match
SINT,SI6,31,0,0,0,9,22,31,Match
SINT,SI60,1,0,0,0,0,1,1,Match
SINT,SI61,1,0,0,0,0,1,1,Match
SINT,SI62,1,0,0,0,0,1,1,Match
SINT,SI63,1,0,0,0,0,1,1,Match
SINT,SI64,1,0,0,0,0,1,1,Match
SINT,SI65,1,0,0,0,0,1,1,Match
SINT,SI66,1,0,0,0,0,1,1,Match
SINT,SI67,1,0,0,0,0,1,1,Match
SINT,SI68,1,0,0,0,0,1,1,Match
SINT,SI7,37,0,0,0,37,0,37,Match
SINT,SI70,1,0,0,0,0,1,1,Match
SINT,SI71,1,0,0,0,0,1,1,Match
SINT,SI72,1,0,0,0,0,1,1,Match
SINT,SI73,1,0,0,0,0,1,1,Match
SINT,SI74,1,0,0,0,0,1,1,Match
SINT,SI76,1,0,0,0,0,1,1,Match
SINT,SI77,1,0,0,0,0,1,1,Match
SINT,SI78,1,0,0,0,0,1,1,Match
SINT,SI79,1,0,0,0,0,1,1,Match
SINT,SI8,40,0,0,0,40,0,40,Match
SINT,SI80,1,0,0,0,0,1,1,Match
SINT,SI81,1,0,0,0,0,1,1,Match
SINT,SI82,1,0,0,0,0,1,1,Match
SINT,SI83,1,0,0,0,0,1,1,Match
SINT,SI84,1,0,0,0,0,1,1,Match
SINT,SI85,1,0,0,0,0,1,1,Match
SINT,SI86,1,0,0,0,0,1,1,Match
SINT,SI9,21,0,0,0,0,21,21,Match
SRAD,SR,1,0,0,0,1,0,1,Match
SRAD,SR1,1,0,0,0,1,0,1,Match
SRAD,SR10,1,0,0,0,1,0,1,Match
SRAD,SR11,1,0,0,0,1,0,1,Match
SRAD,SR12,1,0,0,0,1,0,1,Match
SRAD,SR16,1,0,0,0,0,1,1,Match
SRAD,SR17,1,0,0,0,0,1,1,Match
SRAD,SR19,1,0,0,0,0,1,1,Match
SRAD,SR2,1,0,0,0,1,0,1,Match
SRAD,SR20,1,0,0,0,0,1,1,Match
SRAD,SR204,1,0,0,0,0,1,1,Match
SRAD,SR205,1,0,0,0,0,1,1,Match
SRAD,SR206,1,0,0,0,0,1,1,Match
SRAD,SR207,1,0,0,0,0,1,1,Match
SRAD,SR208,1,0,0,0,0,1,1,Match
SRAD,SR209,1,0,0,0,0,1,1,Match
SRAD,SR21,1,0,0,0,0,1,1,Match
SRAD,SR210,1,0,0,0,0,1,1,Match
SRAD,SR211,1,0,0,0,0,1,1,Match
SRAD,SR212,1,0,0,0,0,1,1,Match
SRAD,SR213,1,0,0,0,0,1,1,Match
SRAD,SR214,1,0,0,0,0,1,1,Match
SRAD,SR215,1,0,0,0,0,1,1,Match
SRAD,SR216,1,0,0,0,0,1,1,Match
SRAD,SR217,1,0,0,0,0,1,1,Match
SRAD,SR218,1,0,0,0,0,1,1,Match
SRAD,SR219,1,0,0,0,0,1,1,Match
SRAD,SR22,1,0,0,0,0,1,1,Match
SRAD,SR220,1,0,0,0,0,1,1,Match
SRAD,SR221,1,0,0,0,0,1,1,Match
SRAD,SR223,1,0,0,0,0,1,1,Match
SRAD,SR224,1,0,0,0,0,1,1,Match
SRAD,SR225,1,0,0,0,0,1,1,Match
SRAD,SR226,1,0,0,0,0,1,1,Match
SRAD,SR227,1,0,0,0,0,1,1,Match
SRAD,SR228,1,0,0,0,0,1,1,Match
SRAD,SR229,1,0,0,0,0,1,1,Match
SRAD,SR230,1,0,0,0,0,1,1,Match
SRAD,SR231,1,0,0,0,0,1,1,Match
SRAD,SR232,1,0,0,0,0,1,1,Match
SRAD,SR233,1,0,0,0,0,1,1,Match
SRAD,SR234,1,0,0,0,0,1,1,Match
SRAD,SR235,1,0,0,0,0,1,1,Match
SRAD,SR236,1,0,0,0,0,1,1,Match
SRAD,SR237,1,0,0,0,0,1,1,Match
SRAD,SR238,1,0,0,0,0,1,1,Match
SRAD,SR239,1,0,0,0,0,1,1,Match
SRAD,SR240,1,0,0,0,0,1,1,Match
SRAD,SR241,1,0,0,0,0,1,1,Match
SRAD,SR242,1,0,0,0,0,1,1,Match
SRAD,SR243,1,0,0,0,0,1,1,Match
SRAD,SR244,1,0,0,0,0,1,1,Match
SRAD,SR245,1,0,0,0,0,1,1,Match
SRAD,SR246,1,0,0,0,0,1,1,Match
SRAD,SR247,1,0,0,0,0,1,1,Match
SRAD,SR248,1,0,0,0,0,1,1,Match
SRAD,SR249,1,0,0,0,0,1,1,Match
SRAD,SR250,1,0,0,0,0,1,1,Match
SRAD,SR251,1,0,0,0,0,1,1,Match
SRAD,SR252,1,0,0,0,0,1,1,Match
SRAD,SR253,1,0,0,0,0,1,1,Match
SRAD,SR254,1,0,0,0,0,1,1,Match
SRAD,SR260,1,0,0,0,0,1,1,Match
SRAD,SR261,1,0,0,0,0,1,1,Match
SRAD,SR262,1,0,0,0,0,1,1,Match
SRAD,SR263,1,0,0,0,0,1,1,Match
SRAD,SR264,1,0,0,0,0,1,1,Match
SRAD,SR265,1,0,0,0,0,1,1,Match
SRAD,SR266,1,0,0,0,0,1,1,Match
SRAD,SR267,1,0,0,0,0,1,1,Match
SRAD,SR268,1,0,0,0,0,1,1,Match
SRAD,SR269,1,0,0,0,0,1,1,Match
SRAD,SR270,1,0,0,0,0,1,1,Match
SRAD,SR271,1,0,0,0,0,1,1,Match
SRAD,SR272,1,0,0,0,0,1,1,Match
SRAD,SR273,1,0,0,0,0,1,1,Match
SRAD,SR274,1,0,0,0,0,1,1,Match
SRAD,SR275,1,0,0,0,0,1,1,Match
SRAD,SR276,1,0,0,0,0,1,1,Match
SRAD,SR277,1,0,0,0,0,1,1,Match
SRAD,SR278,1,0,0,0,0,1,1,Match
SRAD,SR279,1,0,0,0,0,1,1,Match
SRAD,SR280,1,0,0,0,0,1,1,Match
SRAD,SR281,1,0,0,0,0,1,1,Match
SRAD,SR282,1,0,0,0,0,1,1,Match
SRAD,SR283,1,0,0,0,0,1,1,Match
SRAD,SR284,1,0,0,0,0,1,1,Match
SRAD,SR285,1,0,0,0,0,1,1,Match
SRAD,SR286,1,0,0,0,0,1,1,Match
SRAD,SR287,1,0,0,0,0,1,1,Match
SRAD,SR288,1,0,0,0,0,1,1,Match
SRAD,SR289,1,0,0,0,0,1,1,Match
SRAD,SR290,1,0,0,0,0,1,1,Match
SRAD,SR291,1,0,0,0,0,1,1,Match
SRAD,SR292,1,0,0,0,0,1,1,Match
SRAD,SR293,1,0,0,0,0,1,1,Match
SRAD,SR294,1,0,0,0,0,1,1,Match
SRAD,SR295,1,0,0,0,0,1,1,Match
SRAD,SR296,1,0,0,0,0,1,1,Match
SRAD,SR297,1,0,0,0,0,1,1,Match
SRAD,SR298,1,0,0,0,0,1,1,Match
SRAD,SR299,1,0,0,0,0,1,1,Match
SRAD,SR3,1,0,0,0,1,0,1,Match
SRAD,SR300,1,0,0,0,0,1,1,Match
SRAD,SR301,1,0,0,0,0,1,1,Match
SRAD,SR302,1,0,0,0,0,1,1,Match
SRAD,SR303,1,0,0,0,0,1,1,Match
SRAD,SR304,1,0,0,0,0,1,1,Match
SRAD,SR305,1,0,0,0,0,1,1,Match
SRAD,SR306,1,0,0,0,0,1,1,Match
SRAD,SR307,1,0,0,0,0,1,1,Match
SRAD,SR308,1,0,0,0,0,1,1,Match
SRAD,SR309,1,0,0,0,0,1,1,Match
SRAD,SR310,1,0,0,0,0,1,1,Match
SRAD,SR311,1,0,0,0,0,1,1,Match
SRAD,SR312,1,0,0,0,0,1,1,Match
SRAD,SR313,1,0,0,0,0,1,1,Match
SRAD,SR314,1,0,0,0,0,1,1,Match
SRAD,SR315,1,0,0,0,0,1,1,Match
SRAD,SR316,1,0,0,0,0,1,1,Match
SRAD,SR317,1,0,0,0,0,1,1,Match
SRAD,SR318,1,0,0,0,0,1,1,Match
SRAD,SR319,1,0,0,0,0,1,1,Match
SRAD,SR320,1,0,0,0,0,1,1,Match
SRAD,SR321,1,0,0,0,0,1,1,Match
SRAD,SR322,1,0,0,0,0,1,1,Match
SRAD,SR323,1,0,0,0,0,1,1,Match
SRAD,SR324,1,0,0,0,0,1,1,Match
SRAD,SR325,1,0,0,0,0,1,1,Match
SRAD,SR326,1,0,0,0,0,1,1,Match
SRAD,SR327,1,0,0,0,0,1,1,Match
SRAD,SR328,1,0,0,0,0,1,1,Match
SRAD,SR329,1,0,0,0,0,1,1,Match
SRAD,SR330,1,0,0,0,0,1,1,Match
SRAD,SR331,1,0,0,0,0,1,1,Match
SRAD,SR332,1,0,0,0,0,1,1,Match
SRAD,SR333,1,0,0,0,0,1,1,Match
SRAD,SR334,1,0,0,0,0,1,1,Match
SRAD,SR335,1,0,0,0,0,1,1,Match
SRAD,SR336,1,0,0,0,0,1,1,Match
SRAD,SR337,1,0,0,0,0,1,1,Match
SRAD,SR338,2,0,0,0,1,1,2,Match
SRAD,SR339,1,0,0,0,0,1,1,Match
SRAD,SR4,1,0,0,0,1,0,1,Match
SRAD,SR5,1,0,0,0,1,0,1,Match
SRAD,SR6,1,0,0,0,1,0,1,Match
SRAD,SR7,1,0,0,0,1,0,1,Match
SRAD,SR8,1,0,0,0,1,0,1,Match
SRAD,SR9,1,0,0,0,1,0,1,Match
SSID,SS,2,0,0,0,2,0,2,Match
SSID,SS1,29,0,0,0,0,29,29,Match
SSID,SS100,1,0,0,0,1,0,1,Match
SSID,SS101,1,0,0,0,1,0,1,Match
SSID,SS102,1,0,0,0,1,0,1,Match
SSID,SS103,1,0,0,0,1,0,1,Match
SSID,SS104,1,0,0,0,1,0,1,Match
SSID,SS105,1,0,0,0,1,0,1,Match
SSID,SS106,1,0,0,0,1,0,1,Match
SSID,SS107,1,0,0,0,1,0,1,Match
SSID,SS108,1,0,0,0,1,0,1,Match
SSID,SS109,1,0,0,0,1,0,1,Match
SSID,SS110,1,0,0,0,1,0,1,Match
SSID,SS111,1,0,0,0,1,0,1,Match
SSID,SS112,1,0,0,0,1,0,1,Match
SSID,SS113,1,0,0,0,1,0,1,Match
SSID,SS114,1,0,0,0,1,0,1,Match
SSID,SS115,1,0,0,0,1,0,1,Match
SSID,SS116,1,0,0,0,1,0,1,Match
SSID,SS117,1,0,0,0,1,0,1,Match
SSID,SS118,1,0,0,0,1,0,1,Match
SSID,SS119,1,0,0,0,1,0,1,Match
SSID,SS120,1,0,0,0,1,0,1,Match
SSID,SS122,1,0,0,0,0,1,1,Match
SSID,SS123,1,0,0,0,0,1,1,Match
SSID,SS124,1,0,0,0,0,1,1,Match
SSID,SS125,1,0,0,0,0,1,1,Match
SSID,SS126,1,0,0,0,0,1,1,Match
SSID,SS127,1,0,0,0,0,1,1,Match
SSID,SS128,1,0,0,0,0,1,1,Match
SSID,SS129,1,0,0,0,0,1,1,Match
SSID,SS13,1,0,0,1,0,0,1,Match
SSID,SS130,1,0,0,0,0,1,1,Match
SSID,SS131,1,0,0,0,0,1,1,Match
SSID,SS132,1,0,0,0,0,1,1,Match
SSID,SS133,1,0,0,0,0,1,1,Match
SSID,SS134,1,0,0,0,0,1,1,Match
SSID,SS135,1,0,0,0,0,1,1,Match
SSID,SS136,2,0,0,0,0,2,2,Match
SSID,SS137,1,0,0,0,0,1,1,Match
SSID,SS138,1,0,0,0,0,1,1,Match
SSID,SS139,1,0,0,0,0,1,1,Match
SSID,SS14,9,0,9,0,0,0,9,Match
SSID,SS140,1,0,0,0,0,1,1,Match
SSID,SS141,1,0,0,0,0,1,1,Match
SSID,SS142,1,0,0,0,0,1,1,Match
SSID,SS143,1,0,0,0,0,1,1,Match
SSID,SS144,1,0,0,0,0,1,1,Match
SSID,SS145,1,0,0,0,0,1,1,Match
SSID,SS146,1,0,0,0,0,1,1,Match
SSID,SS147,1,0,0,0,0,1,1,Match
SSID,SS148,1,0,0,0,0,1,1,Match
SSID,SS149,1,0,0,0,0,1,1,Match
SSID,SS150,1,0,0,0,0,1,1,Match
SSID,SS151,1,0,0,0,0,1,1,Match
SSID,SS152,1,0,0,0,0,1,1,Match
SSID,SS153,2,0,0,0,0,2,2,Match
SSID,SS154,2,0,0,0,0,2,2,Match
SSID,SS155,2,0,0,0,0,2,2,Match
SSID,SS156,2,0,0,0,0,2,2,Match
SSID,SS157,1,0,0,0,0,1,1,Match
SSID,SS158,1,0,0,0,0,1,1,Match
SSID,SS159,1,0,0,0,0,1,1,Match
SSID,SS160,193,143,50,0,0,0,193,Match
SSID,SS161,1,0,0,0,0,1,1,Match
SSID,SS162,1,0,0,0,0,1,1,Match
SSID,SS163,6,0,0,0,0,6,6,Match
SSID,SS164,1,0,0,0,0,1,1,Match
SSID,SS166,1,0,0,0,0,1,1,Match
SSID,SS167,1,0,0,0,0,1,1,Match
SSID,SS20,10,0,0,0,0,10,10,Match
SSID,SS21,2,0,0,0,0,2,2,Match
SSID,SS23,7,0,0,0,7,0,7,Match
SSID,SS24,12,0,0,0,0,12,12,Match
SSID,SS25,3,0,3,0,0,0,3,Match
SSID,SS26,17,0,0,17,0,0,17,Match
SSID,SS288,1,0,0,0,0,1,1,Match
SSID,SS3,5,0,0,5,0,0,5,Match
SSID,SS311,1,0,0,0,0,1,1,Match
SSID,SS312,1,0,0,0,0,1,1,Match
SSID,SS313,1,0,0,0,0,1,1,Match
SSID,SS314,1,0,0,0,0,1,1,Match
SSID,SS315,1,0,0,0,0,1,1,Match
SSID,SS316,1,0,0,0,0,1,1,Match
SSID,SS317,1,0,0,0,0,1,1,Match
SSID,SS318,1,0,0,0,0,1,1,Match
SSID,SS319,1,0,0,0,0,1,1,Match
SSID,SS320,1,0,0,0,0,1,1,Match
SSID,SS321,1,0,0,0,0,1,1,Match
SSID,SS322,1,0,0,0,0,1,1,Match
SSID,SS323,1,0,0,0,0,1,1,Match
SSID,SS324,1,0,0,0,0,1,1,Match
SSID,SS325,1,0,0,0,0,1,1,Match
SSID,SS326,1,0,0,0,0,1,1,Match
SSID,SS327,1,0,0,0,0,1,1,Match
SSID,SS328,1,0,0,0,0,1,1,Match
SSID,SS329,1,0,0,0,0,1,1,Match
SSID,SS330,1,0,0,0,0,1,1,Match
SSID,SS331,1,0,0,0,0,1,1,Match
SSID,SS332,1,0,0,0,0,1,1,Match
SSID,SS333,1,0,0,0,0,1,1,Match
SSID,SS334,1,0,0,0,0,1,1,Match
SSID,SS335,1,0,0,0,0,1,1,Match
SSID,SS336,1,0,0,0,0,1,1,Match
SSID,SS337,1,0,0,0,0,1,1,Match
SSID,SS338,1,0,0,0,0,1,1,Match
SSID,SS339,1,0,0,0,0,1,1,Match
SSID,SS340,1,0,0,0,0,1,1,Match
SSID,SS341,1,0,0,0,0,1,1,Match
SSID,SS342,1,0,0,0,0,1,1,Match
SSID,SS343,1,0,0,0,0,1,1,Match
SSID,SS344,1,0,0,0,0,1,1,Match
SSID,SS345,1,0,0,0,0,1,1,Match
SSID,SS346,1,0,0,0,0,1,1,Match
SSID,SS347,1,0,0,0,0,1,1,Match
SSID,SS348,1,0,0,0,0,1,1,Match
SSID,SS349,1,0,0,0,0,1,1,Match
SSID,SS350,1,0,0,0,0,1,1,Match
SSID,SS351,1,0,0,0,0,1,1,Match
SSID,SS352,1,0,0,0,0,1,1,Match
SSID,SS353,1,0,0,0,0,1,1,Match
SSID,SS354,1,0,0,0,0,1,1,Match
SSID,SS355,1,0,0,0,0,1,1,Match
SSID,SS356,1,0,0,0,0,1,1,Match
SSID,SS357,1,0,0,0,0,1,1,Match
SSID,SS358,1,0,0,0,0,1,1,Match
SSID,SS359,1,0,0,0,0,1,1,Match
SSID,SS360,1,0,0,0,0,1,1,Match
SSID,SS361,1,0,0,0,0,1,1,Match
SSID,SS362,1,0,0,0,0,1,1,Match
SSID,SS363,1,0,0,0,0,1,1,Match
SSID,SS364,1,0,0,0,0,1,1,Match
SSID,SS365,1,0,0,0,0,1,1,Match
SSID,SS366,1,0,0,0,0,1,1,Match
SSID,SS367,1,0,0,0,0,1,1,Match
SSID,SS368,1,0,0,0,0,1,1,Match
SSID,SS369,1,0,0,0,0,1,1,Match
SSID,SS370,1,0,0,0,0,1,1,Match
SSID,SS371,1,0,0,0,0,1,1,Match
SSID,SS372,1,0,0,0,0,1,1,Match
SSID,SS373,1,0,0,0,0,1,1,Match
SSID,SS374,1,0,0,0,0,1,1,Match
SSID,SS375,1,0,0,0,0,1,1,Match
SSID,SS376,1,0,0,0,0,1,1,Match
SSID,SS377,1,0,0,0,0,1,1,Match
SSID,SS378,1,0,0,0,0,1,1,Match
SSID,SS379,1,0,0,0,0,1,1,Match
SSID,SS380,1,0,0,0,0,1,1,Match
SSID,SS381,1,0,0,0,0,1,1,Match
SSID,SS382,1,0,0,0,0,1,1,Match
SSID,SS383,1,0,0,0,0,1,1,Match
SSID,SS384,1,0,0,0,0,1,1,Match
SSID,SS385,1,0,0,0,0,1,1,Match
SSID,SS386,1,0,0,0,0,1,1,Match
SSID,SS387,1,0,0,0,0,1,1,Match
SSID,SS388,1,0,0,0,0,1,1,Match
SSID,SS389,1,0,0,0,0,1,1,Match
SSID,SS390,1,0,0,0,0,1,1,Match
SSID,SS391,1,0,0,0,0,1,1,Match
SSID,SS392,1,0,0,0,0,1,1,Match
SSID,SS393,1,0,0,0,0,1,1,Match
SSID,SS394,1,0,0,0,0,1,1,Match
SSID,SS395,1,0,0,0,0,1,1,Match
SSID,SS396,1,0,0,0,0,1,1,Match
SSID,SS397,1,0,0,0,0,1,1,Match
SSID,SS398,1,0,0,0,0,1,1,Match
SSID,SS399,1,0,0,0,0,1,1,Match
SSID,SS400,1,0,0,0,0,1,1,Match
SSID,SS401,1,0,0,0,0,1,1,Match
SSID,SS402,1,0,0,0,0,1,1,Match
SSID,SS403,1,0,0,0,0,1,1,Match
SSID,SS404,1,0,0,0,0,1,1,Match
SSID,SS405,1,0,0,0,0,1,1,Match
SSID,SS406,1,0,0,0,0,1,1,Match
SSID,SS407,1,0,0,0,0,1,1,Match
SSID,SS408,1,0,0,0,0,1,1,Match
SSID,SS409,1,0,0,0,0,1,1,Match
SSID,SS410,1,0,0,0,0,1,1,Match
SSID,SS411,1,0,0,0,0,1,1,Match
SSID,SS412,1,0,0,0,0,1,1,Match
SSID,SS413,1,0,0,0,0,1,1,Match
SSID,SS414,1,0,0,0,0,1,1,Match
SSID,SS415,1,0,0,0,0,1,1,Match
SSID,SS416,1,0,0,0,0,1,1,Match
SSID,SS417,1,0,0,0,0,1,1,Match
SSID,SS418,1,0,0,0,0,1,1,Match
SSID,SS419,1,0,0,0,0,1,1,Match
SSID,SS420,1,0,0,0,0,1,1,Match
SSID,SS421,1,0,0,0,0,1,1,Match
SSID,SS422,1,0,0,0,0,1,1,Match
SSID,SS423,1,0,0,0,0,1,1,Match
SSID,SS424,1,0,0,0,0,1,1,Match
SSID,SS425,1,0,0,0,0,1,1,Match
SSID,SS426,1,0,0,0,0,1,1,Match
SSID,SS427,1,0,0,0,0,1,1,Match
SSID,SS428,1,0,0,0,0,1,1,Match
SSID,SS429,1,0,0,0,0,1,1,Match
SSID,SS430,1,0,0,0,0,1,1,Match
SSID,SS431,1,0,0,0,0,1,1,Match
SSID,SS432,1,0,0,0,0,1,1,Match
SSID,SS433,1,0,0,0,0,1,1,Match
SSID,SS434,1,0,0,0,0,1,1,Match
SSID,SS435,1,0,0,0,0,1,1,Match
SSID,SS436,1,0,0,0,0,1,1,Match
SSID,SS437,1,0,0,0,0,1,1,Match
SSID,SS438,1,0,0,0,0,1,1,Match
SSID,SS439,1,0,0,0,0,1,1,Match
SSID,SS440,1,0,0,0,0,1,1,Match
SSID,SS441,1,0,0,0,0,1,1,Match
SSID,SS442,1,0,0,0,0,1,1,Match
SSID,SS443,1,0,0,0,0,1,1,Match
SSID,SS444,1,0,0,0,0,1,1,Match
SSID,SS445,1,0,0,0,0,1,1,Match
SSID,SS446,1,0,0,0,0,1,1,Match
SSID,SS447,1,0,0,0,0,1,1,Match
SSID,SS448,1,0,0,0,0,1,1,Match
SSID,SS449,1,0,0,0,0,1,1,Match
SSID,SS450,1,0,0,0,0,1,1,Match
SSID,SS451,1,0,0,0,0,1,1,Match
SSID,SS452,1,0,0,0,0,1,1,Match
SSID,SS453,1,0,0,0,0,1,1,Match
SSID,SS454,1,0,0,0,0,1,1,Match
SSID,SS455,1,0,0,0,0,1,1,Match
SSID,SS456,1,0,0,0,0,1,1,Match
SSID,SS457,1,0,0,0,0,1,1,Match
SSID,SS458,1,0,0,0,0,1,1,Match
SSID,SS459,1,0,0,0,0,1,1,Match
SSID,SS460,1,0,0,0,0,1,1,Match
SSID,SS461,1,0,0,0,0,1,1,Match
SSID,SS462,1,0,0,0,0,1,1,Match
SSID,SS463,7,0,0,0,0,7,7,Match
SSID,SS464,1,0,0,0,0,1,1,Match
SSID,SS465,1,0,0,0,0,1,1,Match
SSID,SS466,5,0,0,0,5,0,5,Match
SSID,SS467,1,0,0,0,0,1,1,Match
SSID,SS468,1,0,0,0,1,0,1,Match
SSID,SS469,1,0,0,0,1,0,1,Match
SSID,SS470,1,0,0,0,0,1,1,Match
SSID,SS471,1,0,0,0,0,1,1,Match
SSID,SS472,1,0,0,0,0,1,1,Match
SSID,SS473,1,0,0,0,0,1,1,Match
SSID,SS474,1,0,0,0,0,1,1,Match
SSID,SS475,1,0,0,0,0,1,1,Match
SSID,SS476,1,0,0,0,0,1,1,Match
SSID,SS477,1,0,0,0,0,1,1,Match
SSID,SS478,1,0,0,0,0,1,1,Match
SSID,SS479,1,0,0,0,0,1,1,Match
SSID,SS480,1,0,0,0,0,1,1,Match
SSID,SS481,1,0,0,0,0,1,1,Match
SSID,SS482,1,0,0,0,0,1,1,Match
SSID,SS483,1,0,0,0,0,1,1,Match
SSID,SS484,1,0,0,0,0,1,1,Match
SSID,SS485,1,0,0,0,0,1,1,Match
SSID,SS486,1,0,0,0,0,1,1,Match
SSID,SS487,1,0,0,0,0,1,1,Match
SSID,SS488,1,0,0,0,0,1,1,Match
SSID,SS489,1,0,0,0,0,1,1,Match
SSID,SS490,1,0,0,0,0,1,1,Match
SSID,SS491,1,0,0,0,0,1,1,Match
SSID,SS492,1,0,0,0,0,1,1,Match
SSID,SS493,1,0,0,0,0,1,1,Match
SSID,SS494,1,0,0,0,0,1,1,Match
SSID,SS495,1,0,0,0,0,1,1,Match
SSID,SS496,1,0,0,0,0,1,1,Match
SSID,SS497,1,0,0,0,0,1,1,Match
SSID,SS498,1,0,0,0,0,1,1,Match
SSID,SS499,1,0,0,0,0,1,1,Match
SSID,SS500,1,0,0,0,0,1,1,Match
SSID,SS501,1,0,0,0,0,1,1,Match
SSID,SS502,1,0,0,0,0,1,1,Match
SSID,SS503,1,0,0,0,0,1,1,Match
SSID,SS504,1,0,0,0,0,1,1,Match
SSID,SS505,1,0,0,0,0,1,1,Match
SSID,SS506,10,0,0,0,10,0,10,Match
SSID,SS6,10,0,0,0,0,10,10,Match
SSID,SS65,1,0,0,0,0,1,1,Match
SSID,SS8,7,0,7,0,0,0,7,Match
SSID,SS84,1,0,0,0,1,0,1,Match
SSID,SS87,1,0,0,0,1,0,1,Match
SSID,SS88,1,0,0,0,1,0,1,Match
SSID,SS89,1,0,0,0,1,0,1,Match
SSID,SS9,6,0,0,6,0,0,6,Match
SSID,SS90,1,0,0,0,1,0,1,Match
SSID,SS91,8,0,0,0,8,0,8,Match
SSID,SS92,1,0,0,0,1,0,1,Match
SSID,SS93,1,0,0,0,1,0,1,Match
SSID,SS94,1,0,0,0,1,0,1,Match
SSID,SS95,3,0,0,0,3,0,3,Match
SSID,SS96,1,0,0,0,1,0,1,Match
SSID,SS97,1,0,0,0,1,0,1,Match
SSID,SS98,1,0,0,0,1,0,1,Match
SSID,SS99,1,0,0,0,1,0,1,Match
UK,UK,3,0,0,0,2,1,3,Match
UK,UK147,26,0,0,0,0,26,26,Match
UK,UK150,4,0,0,0,0,4,4,Match
UK,UK155,3,0,0,0,0,3,3,Match